2222222222222222
2222222222222222
0001111110000000
1111000011111100
0000000000000100
0011111000111100
0010001000100000
0010001111111110
0010000000000010
0011111111110010
0000000000010011
1111111111110000
2222222222222222