2222222222222222
1111110000000000
0000010000000000
0000011000011111
0000001110010000
0000111010010000
0000100010110000
0000100010100000
1111100011100000
0000000000000000
0000000000000000
2222222222222222