2212222222222222
2212222222222222
0010111100000000
0010100100011111
0011100110010000
0000000010010000
0011111110011100
0010000000000100
0010011111000100
0010010001000100
0011110001111100
0000000000000000
2222222222222222