2222221222222222
2222221222222222
0111111001111110
0100000001000010
0111111111011110
0000000000010000
1111111111111111
0000100000000000
0000101111111110
0111101000000010
0100001001111110
0111111001000000
2222222221222222